0,0,0,0,0,0,0,0,9,8,9,8,9,8,9,8,9,8,9,8,9,8,9,8,9,8,9,8,9,8,9,8,0,0,0,0,0,0,0,1
2,0,0,0,0,0,0,2,16,17,16,17,16,17,16,17,16,17,16,17,16,17,16,17,16,17,16,17,16,17,16,17,1,0,0,0,0,0,0,0
2,10,10,10,10,10,1,2,12,14,15,14,15,14,15,14,15,14,15,14,60,60,60,14,15,14,15,14,15,14,15,12,1,2,10,10,10,10,10,1
2,10,10,10,10,10,1,2,13,12,14,15,14,15,14,15,14,15,14,15,41,43,42,15,14,15,14,15,14,15,12,13,1,2,10,10,10,10,10,1
2,10,10,10,10,10,1,2,12,13,12,14,15,14,15,14,15,14,15,14,41,43,42,14,15,14,15,14,15,12,13,12,1,2,10,10,10,10,10,1
2,10,10,10,10,10,1,2,13,12,13,12,14,15,14,15,14,15,14,15,41,43,42,15,14,15,14,15,12,13,12,13,1,2,10,10,10,10,10,1
2,10,10,10,10,10,1,2,12,13,12,13,12,14,15,14,15,14,15,14,41,43,42,14,15,14,15,12,13,12,13,12,1,2,10,10,10,10,10,1
2,10,10,10,10,10,1,2,13,12,13,12,13,12,14,15,14,15,14,15,41,43,42,33,34,35,12,13,12,13,12,13,1,2,10,10,10,10,10,1
2,10,10,10,10,10,1,2,36,36,36,36,36,36,36,36,36,36,36,36,41,43,42,36,36,36,36,36,36,36,36,36,1,2,10,10,10,10,10,1
2,10,10,10,10,10,1,2,46,46,46,46,46,46,46,46,46,33,34,35,41,43,42,46,46,46,46,46,46,46,46,46,1,2,10,10,10,10,10,1
2,10,10,10,10,10,1,2,12,13,12,13,12,13,14,15,14,15,14,15,41,43,42,33,34,35,13,12,13,12,13,12,1,2,10,10,10,10,10,1
2,10,10,10,10,10,1,2,36,36,36,36,36,36,36,36,36,33,34,35,41,43,42,36,36,36,36,36,36,36,36,36,1,2,10,10,10,10,10,1
2,10,10,10,10,10,1,2,46,46,46,46,46,46,46,46,46,46,46,46,41,43,42,46,46,46,46,46,46,46,46,46,1,2,10,10,10,10,10,1
2,10,10,10,10,10,1,2,13,12,13,14,15,14,15,14,15,33,34,35,41,43,42,33,34,35,15,14,15,13,12,13,1,2,10,10,10,10,10,1
2,10,10,10,10,10,1,2,36,36,36,36,36,36,36,36,36,36,36,36,41,43,42,36,36,36,36,36,36,36,36,36,1,2,10,10,10,10,10,1
2,10,10,10,10,10,1,2,46,46,46,46,46,46,46,46,46,46,46,46,27,43,28,46,46,46,46,46,46,46,46,46,1,2,10,10,10,10,10,1
2,10,10,10,10,10,1,2,21,22,21,22,21,22,21,22,21,22,21,22,37,43,38,22,21,22,21,22,21,22,21,22,1,2,10,10,10,10,10,1
2,10,10,10,10,10,1,2,7,6,7,6,7,6,7,6,7,6,7,6,47,43,48,6,7,6,7,6,7,6,7,6,1,2,10,10,10,10,10,1
2,10,10,10,10,10,11,11,11,11,11,11,11,11,11,11,11,11,11,11,11,11,11,11,11,11,11,11,11,11,11,11,11,11,10,10,10,10,10,1
2,10,10,10,10,10,11,11,11,11,11,11,11,11,11,11,11,11,11,11,11,11,11,11,11,11,11,11,11,11,11,11,11,11,10,10,10,10,10,1
2,10,10,10,10,10,11,11,11,11,11,11,11,11,11,11,11,11,11,11,11,11,11,11,11,11,11,11,11,11,11,11,11,11,10,10,10,10,10,1
2,10,10,10,10,10,11,11,11,11,11,11,11,11,11,11,11,11,11,11,11,11,11,11,11,11,11,11,11,11,11,11,11,11,10,10,10,10,10,1
2,10,10,10,10,10,1,2,9,8,9,8,9,8,9,8,9,8,9,8,9,8,9,8,9,8,9,8,9,8,9,8,1,2,10,10,10,10,10,1
2,10,10,10,10,10,1,2,16,17,16,17,16,17,16,17,16,17,16,17,16,17,16,17,16,17,16,17,16,17,16,17,1,2,10,10,10,10,10,1
2,10,10,10,10,10,1,2,12,14,15,14,15,14,15,14,15,14,15,14,15,14,15,14,15,14,15,14,15,14,15,12,1,2,10,10,10,10,10,1
2,10,10,10,10,10,1,2,13,12,14,15,14,15,14,15,14,15,14,15,14,15,14,15,14,15,14,15,14,15,12,13,1,2,10,10,50,50,10,1
2,10,10,10,10,10,1,2,12,13,12,14,15,14,15,14,15,14,15,14,15,14,15,14,15,14,15,14,15,12,13,12,1,2,10,10,10,10,10,1
2,10,10,10,10,10,1,2,13,12,13,12,14,15,14,15,14,15,14,15,14,15,14,15,14,15,14,15,12,13,12,13,1,2,10,10,10,10,10,1
2,10,10,10,10,10,1,2,12,13,12,13,12,14,15,14,15,14,15,14,15,14,15,14,15,14,15,12,13,12,13,12,1,2,10,10,10,10,10,1
2,10,10,10,10,10,1,2,13,12,13,12,13,12,14,15,14,15,14,15,14,15,14,15,14,15,12,13,12,13,12,13,1,2,10,10,10,10,10,1
2,10,10,10,10,10,1,2,12,13,12,13,12,13,12,14,15,12,12,14,15,12,12,14,15,12,13,12,13,12,13,12,1,2,10,10,10,10,10,1
2,10,10,10,10,10,1,2,13,12,13,12,13,12,13,14,15,13,13,14,15,13,13,14,15,13,12,13,12,13,12,13,1,2,10,10,10,10,10,1
2,10,10,10,10,10,1,2,12,13,12,13,12,13,14,15,14,15,14,15,14,15,14,15,14,15,13,12,13,12,13,12,1,2,10,10,10,10,10,1
2,10,10,10,10,10,1,2,13,12,13,12,13,14,15,14,15,14,15,14,15,14,15,14,15,14,15,13,12,13,12,13,1,2,10,10,10,10,10,1
2,10,10,10,10,10,1,2,12,13,12,13,14,15,14,15,14,15,14,15,14,15,14,15,14,15,14,15,13,12,13,12,1,2,10,10,10,10,10,1
2,10,10,10,10,10,1,2,13,12,13,14,15,14,15,14,15,14,15,14,15,14,15,14,15,14,15,14,15,13,12,13,1,2,10,10,10,10,10,1
2,10,10,10,10,10,1,2,12,13,14,15,14,15,14,15,14,15,14,15,14,15,14,15,14,15,14,15,14,15,13,12,1,2,10,10,10,10,10,1
2,10,10,10,10,10,1,2,13,14,15,14,15,14,15,14,15,14,15,14,15,14,15,14,15,14,15,14,15,14,15,13,1,2,10,10,10,10,10,1
0,3,3,3,3,3,0,0,0,0,0,0,0,0,0,0,0,0,0,0,0,0,0,0,0,0,0,0,0,0,0,0,1,2,0,0,0,0,0,0
0,0,0,0,0,0,0,0,0,0,0,0,0,0,0,0,0,0,0,0,0,0,0,0,0,0,0,0,0,0,0,0,0,0,0,0,0,0,0,0
